XXXXXXXX
X......X
X......X
........
........
X......X
X......X
XXX..XXX
END