XXX..XXX
X......X
X......X
........
........
X......X
X......X
XXXXXXXX
END