XXX..XXX
X......X
X......X
.......X
.......X
X......X
X......X
XXX..XXX
END