217..913
0......0
8......8
........
........
6......6
0......0
51111114
END