21111113
0......0
8......8
........
........
6......6
0......0
517..914
END