217..913
0......0
8......0
.......0
.......0
6......0
0......0
517..914
END